//abe
int abe[] = {
0, 0, 0, 0, 0 ,0, 0, 0, 0, 0, 0, 0, 0, 0, 0,
0, 0, 0, 0, 0, 0, 0, 0, 0, 0, 0, 0, 0, 0, 0,
0, 1, 1, 1, 1, 0, 1, 1, 1, 1, 0, 1, 1, 1, 1,
0, 1, 0, 0, 1, 0, 1, 0, 0, 1, 0, 1, 0, 0, 0,
0, 1, 0, 0, 1, 0, 1, 0, 0, 1, 0, 1, 0, 0, 0,
0, 1, 1, 1, 1, 0, 1, 1, 1, 1, 0, 1, 1, 1, 0,
0, 1, 0, 0, 1, 0, 1, 0, 0, 1, 0, 1, 0, 0, 0,
0, 1, 0, 0, 1, 0, 1, 1, 1, 1, 0, 1, 1, 1, 1,
0, 0, 0, 0, 0, 0, 0, 0, 0, 0, 0, 0, 0, 0, 0,
};

//nate
int nateabe[] = {
0, 0, 0, 0, 0 ,0, 0, 0, 0, 0, 0, 0, 0, 0, 0,
0, 0, 0, 0, 0, 0, 0, 0, 0, 0, 0, 0, 0, 0, 0,
0, 1, 1, 1, 1, 0, 1, 1, 1, 1, 0, 1, 1, 1, 1,
0, 1, 0, 0, 1, 0, 1, 0, 0, 1, 0, 1, 0, 0, 0,
0, 1, 0, 0, 1, 0, 1, 1, 1, 1, 0, 1, 0, 0, 0,
0, 1, 1, 1, 1, 0, 1, 0, 0, 1, 0, 1, 1, 1, 0,
0, 1, 0, 0, 1, 0, 1, 0, 0, 1, 0, 1, 0, 0, 0,
0, 1, 0, 0, 1, 0, 1, 1, 1, 1, 0, 1, 1, 1, 1,
1, 1, 1, 1, 1, 1, 1, 1, 1, 1, 1, 1, 1, 1, 1,
};
int startposition[][] {[16*6, 16*2+8], [16*5, 16*4+8], [16*9, 16*4+8]} 


//level1
u16 x = 16*6;
u16 y = 16*2+8;
int level1[] = {
0, 0, 0, 0, 0 ,0, 0, 0, 0, 0, 0, 0, 0, 0, 0,
0, 0, 0, 0, 0, 0, 0, 0, 0, 0, 0, 0, 0, 0, 0,
0, 0, 0, 0, 0, 1, 1, 1, 1, 1, 0, 0, 0, 0, 0,
0, 0, 0, 0, 0, 1, 0, 0, 0, 1, 0, 0, 0, 0, 0,
0, 0, 0, 0, 0, 1, 0, 0, 0, 1, 0, 0, 0, 0, 0,
0, 0, 0, 0, 0, 1, 1, 1, 1, 1, 0, 0, 0, 0, 0,
0, 0, 0, 0, 0, 0, 0, 0, 0, 0, 0, 0, 0, 0, 0,
0, 0, 0, 0, 0, 0, 0, 0, 0, 0, 0, 0, 0, 0, 0,
0, 0, 0, 0, 0, 0, 0, 0, 0, 0, 0, 0, 0, 0, 0,
};

//level2
u16 x = 16*5;
u16 y = 16*4+8;
int level2[] = {
0, 0, 0, 0, 0 ,0, 0, 0, 0, 0, 0, 0, 0, 0, 0,
0, 0, 0, 0, 0, 0, 0, 0, 0, 0, 0, 0, 0, 0, 0,
0, 0, 0, 0, 0, 1, 1, 1, 1, 1, 0, 0, 0, 0, 0,
0, 0, 0, 0, 0, 1, 0, 0, 0, 1, 0, 0, 0, 0, 0,
0, 0, 0, 0, 0, 1, 0, 0, 0, 1, 0, 0, 0, 0, 0,
0, 0, 0, 0, 0, 1, 1, 1, 1, 1, 0, 0, 0, 0, 0,
0, 0, 0, 0, 0, 1, 0, 0, 0, 1, 0, 0, 0, 0, 0,
0, 0, 0, 0, 0, 1, 1, 1, 1, 1, 0, 0, 0, 0, 0,
0, 0, 0, 0, 0, 0, 0, 0, 0, 0, 0, 0, 0, 0, 0,
};
//level 3
u16 x = 16*9;
u16 y = 16*4+8;
int level3[] = {
0, 0, 1, 1, 1 ,0, 0, 0, 0, 0, 1, 1, 1, 0, 0,
0, 0, 1, 0, 1, 0, 0, 0, 0, 0, 1, 0, 1, 0, 0,
0, 0, 1, 0, 1, 1, 1, 1, 1, 1, 1, 0, 1, 0, 0,
0, 0, 1, 1, 1, 1, 0, 0, 0, 1, 1, 1, 1, 0, 0,
0, 0, 0, 1, 1, 1, 0, 0, 0, 1, 0, 1, 1, 0, 0,
0, 0, 1, 1, 0, 1, 1, 1, 1, 1, 1, 1, 1, 0, 0,
0, 0, 1, 0, 0, 0, 0, 0, 0, 0, 0, 0, 1, 0, 0,
0, 0, 1, 1, 1, 1, 1, 1, 1, 1, 1, 1, 1, 0, 0,
0, 0, 0, 0, 0, 0, 0, 0, 0, 0, 0, 0, 0, 0, 0,
};
